[h: 10 ; w: 19]
###################
#           #     #
# ## # ###  # ##  #
#  # # # B  # #  ##
# ########### #   #
#     # # #   # ###
##### #     ###   #
# #   # # #  #### #
#       # #  #N   #
###################

В свободной области можно 
писать комментарии.